50 75
0 0 0 0 0 0 0 0 0 0 0 0 0 0 0 0 0 0 0 0 0 0 0 0 0 0 -1 -1 -1 1 -1 -1 -1 1 -1 -1 -1 -1 -1 0 0 0 1 -1 -1 -1 -1 -1 -1 -1
0 0 0 0 0 0 0 0 0 0 0 0 0 0 0 0 0 0 0 0 0 0 0 0 0 0 -1 -1 -1 1 -1 -1 -1 1 -1 -1 -1 -1 -1 0 1 1 1 -1 -1 -1 -1 -1 -1 -1
1 1 1 1 1 1 1 1 1 1 1 1 1 0 0 0 0 0 0 0 0 0 0 0 0 0 -1 -1 -1 1 -1 -1 -1 1 -1 -1 -1 -1 -1 0 1 1 1 -1 -1 -1 -1 -1 -1 -1
1 1 1 1 1 1 1 1 1 1 1 1 1 0 0 0 0 0 1 -1 -1 -1 -1 0 0 0 -1 -1 -1 1 -1 -1 -1 1 -1 -1 -1 -1 -1 0 1 1 1 -1 3 -1 -1 -1 -1 -1
1 1 1 1 1 1 1 1 1 1 1 1 1 0 0 0 0 0 -1 -1 -1 -1 -1 0 0 0 -1 -1 -1 1 -1 -1 -1 1 -1 -1 -1 -1 -1 0 0 0 6 -1 -1 -1 -1 -1 -1 -1
1 1 1 1 1 1 1 1 1 1 1 1 1 0 0 0 0 0 -1 -1 -1 -1 -1 0 0 0 -1 -1 -1 1 -1 -1 -1 1 -1 -1 -1 -1 -1 0 0 0 1 -1 -1 -1 -1 10 -1 10
1 1 1 1 1 1 1 1 1 1 1 1 1 0 0 0 0 0 -1 -1 -1 -1 -1 0 0 0 -1 -1 -1 1 -1 -1 1 1 -1 -1 -1 -1 -1 0 0 0 1 -1 1 1 5 0 0 0
1 1 1 3 1 1 1 1 1 3 1 1 1 1 1 1 1 14 -1 -1 -1 -1 -1 0 0 0 -1 -1 -1 1 -1 -1 1 1 -1 -1 -1 -1 -1 0 0 0 1 -1 -1 -1 -1 0 0 0
1 1 1 1 1 1 15 1 1 1 1 1 1 1 1 10 1 14 -1 -1 -1 -1 -1 0 0 0 -1 -1 -1 1 -1 -1 1 1 -1 -1 -1 -1 -1 0 0 0 1 -1 3 -1 -1 0 0 0
1 1 1 1 1 1 1 1 1 1 1 1 1 0 0 0 0 0 14 14 14 14 14 0 0 0 -1 -1 -1 1 -1 -1 1 1 -1 -1 -1 -1 -1 0 0 0 1 -1 -1 -1 -1 0 0 0
1 1 1 1 1 1 1 1 1 1 1 1 1 0 0 0 0 0 1 -1 -1 -1 -1 0 0 0 -1 -1 1 1 -1 -1 -1 1 -1 -1 -1 -1 -1 0 0 0 1 -1 -1 -1 -1 0 0 0
1 1 1 1 1 1 3 1 1 1 1 1 1 0 0 0 0 0 -1 -1 -1 -1 -1 0 0 0 -1 -1 1 1 -1 1 -1 1 -1 -1 -1 -1 -1 0 0 0 1 -1 -1 -1 -1 0 0 0
1 1 1 1 1 1 1 1 1 1 1 1 1 0 0 0 0 0 -1 15 -1 -1 1 0 0 0 -1 -1 1 1 -1 1 -1 1 -1 -1 -1 -1 -1 0 0 0 1 -1 1 -1 -1 0 0 0
1 1 1 1 1 1 1 1 1 1 1 1 1 0 0 0 0 0 14 14 14 14 14 0 0 0 -1 -1 1 1 1 -1 -1 1 -1 -1 -1 -1 -1 0 0 0 1 -1 3 -1 -1 0 0 0
1 -1 1 -1 -1 1 1 1 1 1 -1 -1 -1 0 0 0 0 0 -1 -1 1 -1 15 0 0 0 -1 -1 1 1 1 -1 -1 1 -1 -1 -1 -1 -1 0 0 0 1 -1 -1 -1 -1 0 0 0
1 -1 -1 -1 -1 1 9 1 1 1 -1 -1 -1 0 0 0 0 0 15 -1 -1 -1 -1 0 0 0 -1 -1 -1 1 1 -1 -1 1 -1 -1 -1 -1 -1 0 0 0 1 -1 -1 -1 -1 0 0 0
1 -1 -1 -1 5 0 0 0 1 -1 -1 -1 -1 0 0 0 0 0 -1 -1 -1 -1 -1 0 0 0 -1 -1 -1 1 -1 -1 -1 1 -1 -1 -1 -1 -1 0 0 0 1 -1 -1 -1 -1 0 0 0
1 1 1 -1 1 0 0 0 11 11 11 11 11 0 0 0 0 0 -1 -1 15 -1 -1 0 0 0 -1 -1 -1 1 -1 -1 -1 1 -1 -1 -1 -1 -1 0 0 0 1 -1 -1 -1 -1 0 0 0
-1 -1 -1 -1 -1 0 0 0 1 -1 -1 -1 -1 0 0 0 0 0 14 14 14 14 14 0 0 0 -1 -1 -1 1 -1 -1 -1 1 1 -1 -1 -1 -1 0 0 0 1 -1 -1 -1 15 0 0 0
15 -1 -1 -1 -1 0 0 0 1 1 1 1 -1 0 0 0 0 0 -1 -1 -1 15 -1 0 0 0 -1 -1 -1 1 -1 1 1 1 -1 -1 -1 -1 -1 0 0 0 1 -1 -1 5 11 0 0 0
11 6 -1 -1 -1 0 0 0 1 -1 15 -1 -1 0 0 0 0 0 15 -1 -1 -1 -1 0 0 0 -1 -1 -1 1 1 1 -1 1 -1 -1 -1 -1 -1 0 0 0 1 -1 -1 -1 -1 0 0 0
-1 1 1 1 1 0 0 0 1 1 -1 -1 -1 0 0 0 0 0 -1 -1 -1 -1 -1 -1 14 -1 -1 -1 -1 1 1 -1 -1 1 -1 -1 -1 -1 -1 0 0 0 1 -1 -1 -1 -1 0 0 0
-1 -1 1 1 -1 0 0 0 1 1 -1 -1 1 0 0 0 0 0 -1 -1 -1 -1 -1 -1 14 -1 -1 -1 -1 1 -1 -1 -1 1 -1 -1 -1 -1 -1 0 0 0 1 -1 -1 -1 -1 0 0 0
-1 -1 -1 -1 1 0 0 0 1 1 -1 -1 -1 0 0 0 0 0 -1 -1 -1 -1 -1 -1 14 -1 -1 -1 -1 1 -1 -1 -1 1 -1 -1 -1 -1 -1 0 0 0 6 -1 -1 -1 -1 0 0 0
6 -1 -1 -1 1 0 0 0 11 11 11 11 6 0 0 0 0 0 -1 -1 -1 -1 -1 9 14 1 1 -1 -1 1 -1 -1 -1 1 -1 -1 -1 -1 -1 0 0 0 1 -1 -1 -1 1 0 0 0
-1 -1 -1 -1 -1 0 0 0 1 -1 -1 -1 -1 0 0 0 0 0 -1 -1 -1 -1 5 0 0 0 1 -1 1 1 -1 -1 -1 1 -1 -1 -1 -1 -1 0 0 0 1 -1 -1 -1 1 0 0 0
-1 -1 -1 -1 -1 0 0 0 1 -1 -1 -1 1 0 0 0 0 0 -1 -1 -1 1 1 0 0 0 1 1 1 1 -1 -1 -1 1 -1 -1 -1 -1 -1 0 0 0 15 -1 -1 -1 1 0 0 0
-1 -1 -1 -1 15 0 0 0 1 1 15 1 1 0 0 0 0 0 -1 -1 -1 1 1 0 0 0 1 1 1 1 -1 -1 -1 1 -1 -1 -1 -1 -1 0 0 0 11 6 -1 -1 1 0 0 0
-1 -1 5 11 11 0 0 0 1 -1 -1 -1 1 0 0 0 0 0 6 -1 -1 1 1 0 0 0 1 1 1 1 -1 -1 1 1 -1 -1 -1 -1 -1 0 0 0 -1 -1 -1 -1 1 0 0 0
-1 -1 -1 -1 -1 0 0 0 1 1 -1 1 1 0 0 0 0 0 -1 -1 -1 1 -1 0 0 0 1 1 -1 1 -1 -1 -1 1 -1 -1 -1 -1 -1 0 0 0 -1 -1 -1 -1 -1 0 0 0
1 1 1 -1 -1 0 0 0 14 14 14 14 14 0 0 0 0 0 -1 -1 -1 -1 -1 0 0 0 -1 -1 -1 1 1 -1 -1 1 -1 -1 -1 -1 -1 0 0 0 15 15 -1 -1 -1 0 0 0
-1 1 1 -1 15 0 0 0 1 1 1 1 1 0 0 0 0 0 15 -1 -1 -1 -1 0 0 0 -1 -1 -1 1 -1 -1 1 1 -1 -1 -1 -1 -1 0 0 0 11 11 6 -1 -1 0 0 0
-1 -1 1 5 11 0 0 0 1 1 -1 -1 -1 0 0 0 0 0 11 11 6 -1 -1 0 0 0 -1 -1 -1 1 1 -1 1 1 -1 -1 -1 -1 -1 0 0 0 -1 1 1 -1 -1 0 0 0
-1 -1 1 1 1 0 0 0 1 -1 -1 -1 -1 0 0 0 0 0 -1 -1 -1 -1 -1 0 0 0 -1 -1 -1 1 1 -1 1 1 -1 -1 -1 -1 -1 0 0 0 -1 -1 -1 -1 -1 0 0 0
-1 -1 -1 -1 -1 0 0 0 1 -1 -1 -1 -1 0 0 0 0 0 -1 -1 -1 -1 1 0 0 0 -1 -1 -1 1 1 -1 1 1 -1 -1 -1 -1 -1 0 0 0 -1 -1 -1 -1 -1 0 0 0
-1 -1 -1 -1 -1 0 0 0 15 -1 -1 -1 15 0 0 0 0 0 -1 -1 -1 -1 5 0 0 0 -1 -1 -1 1 1 -1 1 1 -1 -1 -1 -1 -1 0 0 0 -1 -1 -1 -1 5 0 0 0
6 -1 -1 -1 -1 0 0 0 11 11 11 11 11 0 0 0 0 0 1 3 1 -1 1 0 0 0 -1 -1 -1 1 -1 -1 -1 1 -1 -1 -1 -1 -1 0 0 0 -1 -1 -1 -1 -1 0 0 0
1 1 1 -1 -1 0 0 0 1 -1 -1 -1 -1 0 0 0 0 0 1 -1 -1 -1 -1 0 0 0 -1 -1 -1 1 -1 -1 1 1 1 -1 -1 -1 -1 0 0 0 -1 -1 -1 -1 -1 0 0 0
1 1 -1 -1 -1 0 0 0 1 -1 -1 -1 1 0 0 0 0 0 -1 -1 -1 -1 -1 0 0 0 -1 -1 -1 1 -1 -1 1 1 1 -1 -1 -1 -1 0 0 0 15 -1 -1 -1 15 0 0 0
15 1 -1 -1 -1 0 0 0 1 -1 -1 -1 -1 0 0 0 0 0 -1 -1 -1 -1 15 0 0 0 -1 -1 -1 1 -1 1 1 1 1 -1 -1 -1 -1 0 0 0 11 11 11 11 11 0 0 0
11 6 -1 -1 -1 0 0 0 1 -1 15 -1 -1 0 0 0 0 0 -1 -1 -1 5 11 0 0 0 -1 -1 -1 1 -1 1 1 1 1 -1 -1 -1 -1 0 0 0 -1 -1 -1 -1 -1 0 0 0
1 1 1 -1 -1 0 0 0 1 1 1 1 1 0 0 0 0 0 -1 -1 -1 -1 -1 0 0 0 -1 -1 -1 1 -1 -1 1 1 1 -1 -1 -1 -1 0 0 0 -1 -1 -1 -1 -1 0 0 0
1 -1 -1 -1 -1 0 0 0 1 -1 -1 -1 1 0 0 0 0 0 -1 -1 -1 -1 -1 0 0 0 -1 -1 -1 1 1 -1 1 1 1 -1 -1 -1 -1 0 0 0 -1 -1 -1 -1 -1 0 0 0
1 15 -1 -1 -1 0 0 0 1 -1 1 1 1 0 0 0 0 0 -1 -1 -1 -1 1 0 0 0 -1 -1 -1 1 1 -1 1 1 1 -1 -1 -1 -1 0 0 0 6 -1 -1 -1 1 0 0 0
11 11 6 -1 1 0 0 0 14 14 14 14 14 0 0 0 0 0 11 11 11 11 11 0 0 0 -1 -1 -1 1 -1 -1 -1 1 -1 -1 -1 -1 -1 0 0 0 -1 -1 -1 -1 -1 0 0 0
1 -1 -1 -1 -1 0 0 0 1 -1 -1 -1 1 0 0 0 0 0 -1 -1 -1 -1 1 0 0 0 -1 -1 1 1 -1 -1 -1 1 -1 -1 -1 -1 -1 0 0 0 -1 -1 -1 -1 -1 0 0 0
1 -1 -1 -1 5 0 0 0 1 1 -1 -1 1 0 0 0 0 0 -1 -1 -1 -1 1 0 0 0 -1 -1 1 1 -1 -1 -1 1 -1 -1 -1 -1 -1 0 0 0 -1 -1 -1 -1 15 0 0 0
1 1 1 -1 1 0 0 0 1 1 1 1 1 0 0 0 0 0 15 -1 -1 -1 1 0 0 0 -1 -1 1 1 -1 -1 -1 1 -1 -1 -1 -1 -1 0 0 0 -1 -1 -1 5 11 0 0 0
6 1 1 1 1 0 0 0 1 1 1 1 1 0 0 0 0 0 11 11 6 -1 1 0 0 0 -1 -1 1 1 -1 -1 -1 1 -1 -1 -1 -1 -1 0 0 0 -1 -1 -1 -1 -1 0 0 0
1 1 1 1 1 0 0 0 1 1 1 1 1 0 0 0 0 0 -1 -1 -1 -1 1 0 0 0 -1 -1 -1 1 -1 -1 -1 1 -1 -1 -1 -1 -1 0 0 0 -1 -1 -1 -1 -1 0 0 0
-1 -1 -1 -1 -1 0 0 0 1 1 1 1 1 0 0 0 0 0 -1 -1 -1 -1 5 0 0 0 -1 -1 1 1 -1 -1 -1 1 -1 -1 -1 -1 -1 0 0 0 -1 -1 -1 -1 -1 0 0 0
-1 -1 15 -1 -1 0 0 0 15 -1 -1 -1 15 0 0 0 0 0 1 -1 3 1 1 0 0 0 -1 -1 1 1 -1 -1 -1 1 -1 -1 -1 -1 -1 0 0 0 -1 -1 -1 -1 5 0 0 0
-1 -1 5 11 11 0 0 0 11 11 11 11 11 0 0 0 0 0 1 -1 -1 -1 1 0 0 0 -1 -1 1 1 -1 -1 -1 1 -1 -1 -1 -1 -1 0 0 0 -1 -1 -1 -1 -1 0 0 0
-1 -1 -1 -1 -1 0 0 0 -1 -1 -1 -1 -1 0 0 0 0 0 -1 -1 -1 -1 1 0 0 0 -1 -1 1 1 -1 -1 -1 1 -1 -1 -1 -1 -1 0 0 0 -1 -1 -1 -1 -1 0 0 0
-1 -1 -1 -1 -1 0 0 0 -1 -1 -1 -1 -1 0 0 0 0 0 -1 -1 -1 -1 1 0 0 0 -1 -1 -1 1 -1 -1 -1 1 -1 -1 -1 -1 -1 0 0 0 6 -1 -1 -1 -1 0 0 0
-1 -1 -1 -1 15 0 0 0 -1 -1 15 -1 -1 0 0 0 0 0 -1 -1 -1 -1 15 0 0 0 -1 -1 -1 1 -1 -1 -1 1 -1 -1 -1 -1 -1 0 0 0 -1 -1 -1 -1 -1 0 0 0
-1 -1 -1 5 11 0 0 0 -1 -1 -1 -1 -1 0 0 0 0 0 -1 -1 5 11 11 0 0 0 -1 -1 -1 1 -1 -1 -1 1 -1 -1 -1 -1 -1 0 0 0 -1 -1 -1 -1 -1 0 0 0
-1 -1 -1 -1 -1 0 0 0 -1 -1 -1 -1 -1 0 0 0 0 0 -1 -1 -1 -1 -1 0 0 0 -1 -1 -1 1 -1 -1 -1 1 -1 -1 -1 -1 -1 0 0 0 -1 -1 15 -1 -1 0 0 0
-1 -1 -1 -1 -1 0 0 0 -1 -1 -1 -1 -1 0 0 0 0 0 -1 -1 -1 -1 -1 0 0 0 -1 -1 -1 1 -1 -1 -1 1 1 -1 -1 -1 -1 0 0 0 -1 -1 5 11 11 0 0 0
1 -1 -1 -1 -1 0 0 0 14 14 14 14 14 0 0 0 0 0 -1 -1 -1 -1 5 0 0 0 -1 -1 -1 1 -1 -1 -1 1 1 -1 -1 -1 -1 0 0 0 -1 -1 -1 -1 -1 0 0 0
6 -1 -1 -1 -1 0 0 0 -1 -1 -1 -1 -1 0 0 0 0 0 -1 3 -1 -1 1 0 0 0 -1 -1 -1 1 -1 -1 -1 1 1 -1 -1 -1 -1 0 0 0 -1 -1 -1 -1 -1 0 0 0
-1 -1 -1 -1 -1 0 0 0 -1 -1 -1 -1 -1 0 0 0 0 0 -1 -1 -1 -1 1 0 0 0 -1 -1 -1 1 -1 -1 -1 1 1 -1 -1 -1 -1 0 0 0 -1 -1 -1 -1 -1 0 0 0
-1 -1 -1 -1 -1 0 0 0 -1 -1 -1 -1 -1 0 0 0 0 0 -1 -1 -1 -1 1 0 0 0 -1 -1 -1 1 -1 -1 -1 1 1 -1 -1 -1 -1 0 0 0 -1 -1 -1 -1 5 0 0 0
15 -1 -1 -1 -1 0 0 0 -1 -1 -1 -1 -1 0 0 0 0 0 -1 -1 -1 -1 1 0 0 0 -1 -1 -1 1 -1 -1 -1 1 1 -1 -1 -1 -1 0 0 0 1 -1 -1 -1 -1 0 0 0
11 6 -1 -1 -1 0 0 0 -1 -1 -1 -1 -1 0 0 0 0 0 -1 -1 -1 -1 15 0 0 0 -1 -1 -1 1 1 -1 -1 1 -1 -1 -1 -1 1 0 0 0 0 15 -1 1 1 0 0 0
-1 -1 -1 -1 -1 0 0 0 15 -1 -1 -1 15 0 0 0 0 0 -1 -1 -1 5 11 0 0 0 -1 -1 -1 1 1 1 1 1 1 -1 1 1 1 0 0 0 0 0 -1 1 1 0 0 0
-1 -1 -1 -1 -1 0 0 0 11 11 11 11 11 0 0 0 0 0 -1 -1 -1 -1 -1 0 0 0 -1 -1 -1 1 1 1 1 1 1 -1 1 1 1 0 0 0 0 0 0 1 1 0 0 0
-1 -1 15 1 -1 0 0 0 -1 -1 -1 -1 -1 0 0 0 0 0 -1 -1 -1 -1 -1 0 0 0 -1 -1 -1 1 -1 1 1 1 1 -1 1 1 1 0 0 0 0 0 0 1 1 0 0 0
-1 -1 5 11 11 0 0 0 -1 -1 -1 -1 -1 0 0 0 0 0 -1 -1 -1 -1 -1 0 0 0 -1 -1 -1 1 -1 1 1 1 1 -1 1 1 1 0 0 0 0 0 0 1 1 0 0 0
-1 -1 -1 -1 -1 0 0 0 -1 -1 15 -1 -1 0 0 0 0 0 6 -1 -1 -1 -1 0 0 0 -1 -1 -1 1 -1 1 1 1 1 -1 1 1 1 0 0 0 0 0 0 11 11 0 0 0
-1 1 1 1 -1 0 0 0 -1 -1 -1 1 -1 0 0 0 0 0 -1 -1 -1 -1 -1 0 0 0 -1 -1 -1 1 -1 1 1 1 1 -1 -1 1 1 0 0 0 0 0 0 1 1 0 0 0
-1 -1 -1 -1 -1 0 0 0 -1 -1 -1 1 1 14 1 1 1 1 -1 -1 -1 -1 -1 0 0 0 -1 -1 -1 1 -1 1 1 1 1 -1 -1 -1 1 1 1 1 1 -1 -1 1 1 0 0 0
9 -1 -1 -1 9 0 0 0 -1 -1 -1 -1 -1 14 1 1 1 1 -1 -1 -1 -1 -1 0 0 0 -1 -1 9 1 -1 10 1 1 9 -1 -1 10 -1 -1 9 -1 -1 10 -1 1 1 0 0 0
0 0 0 0 0 0 0 0 0 0 0 0 0 0 0 0 0 0 0 0 0 0 0 0 0 0 0 0 0 0 0 0 0 0 0 0 0 0 0 0 0 0 0 0 0 0 0 0 0 0
0 0 0 0 0 0 0 0 0 0 0 0 0 0 0 0 0 0 0 0 0 0 0 0 0 0 0 0 0 0 0 0 0 0 0 0 0 0 0 0 0 0 0 0 0 0 0 0 0 0