17 50
1 1 1 1 1 1 1 0 0 1 1 1 1 1 1 -1 -1
1 1 1 1 1 1 1 1 1 1 1 1 1 1 1 -1 -1
1 1 1 1 1 1 1 1 1 1 1 1 1 1 1 -1 -1
11 11 6 1 1 1 1 1 1 1 1 1 1 1 1 -1 -1
1 1 1 1 1 1 1 1 1 1 1 1 1 1 1 -1 -1
1 1 1 1 1 1 1 1 1 1 1 1 1 1 1 -1 -1
1 1 1 1 1 1 0 0 0 0 1 1 1 1 1 -1 -1
1 1 1 1 1 0 0 0 0 0 0 1 1 1 1 -1 -1
11 6 1 1 0 0 0 0 0 0 0 0 1 1 1 -1 -1
1 1 1 1 0 0 0 0 0 0 0 0 1 1 1 -1 -1
1 1 1 0 0 0 0 0 0 0 0 0 0 1 1 -1 -1
1 1 1 0 0 0 0 0 0 0 0 0 0 1 1 -1 -1
1 1 1 1 0 0 0 0 0 0 0 0 1 1 1 -1 -1
11 11 6 1 1 0 0 0 0 0 0 1 1 1 1 -1 -1
-1 -1 1 -1 -1 -1 -1 0 0 1 -1 -1 -1 -1 -1 -1 1
-1 -1 -1 -1 -1 -1 -1 0 0 1 -1 -1 -1 1 5 11 11
-1 -1 -1 -1 -1 -1 -1 0 0 -1 -1 -1 -1 -1 -1 -1 -1
11 11 6 -1 -1 -1 -1 0 0 -1 -1 -1 -1 -1 -1 -1 -1
-1 -1 -1 -1 -1 -1 -1 0 0 -1 -1 -1 -1 -1 -1 -1 -1
-1 -1 -1 -1 -1 -1 -1 0 0 11 11 6 -1 -1 -1 -1 -1
-1 -1 -1 -1 -1 -1 -1 0 0 -1 -1 -1 -1 -1 -1 -1 -1
-1 -1 -1 5 11 11 11 0 0 -1 -1 -1 -1 -1 -1 -1 -1
-1 -1 -1 -1 -1 -1 -1 0 0 1 -1 -1 5 11 11 11 11
-1 -1 -1 -1 -1 -1 -1 0 0 -1 -1 -1 -1 -1 -1 -1 -1
-1 -1 -1 -1 -1 5 11 0 0 11 6 -1 -1 -1 -1 -1 -1
-1 -1 -1 -1 -1 -1 -1 0 0 -1 -1 -1 -1 -1 -1 -1 -1
-1 -1 -1 -1 -1 -1 -1 0 0 -1 -1 -1 -1 -1 -1 -1 -1
-1 -1 -1 -1 5 11 11 0 0 11 11 11 11 11 6 -1 -1
-1 -1 -1 -1 -1 -1 -1 0 0 -1 -1 -1 -1 -1 -1 -1 -1
-1 -1 -1 -1 -1 -1 -1 0 0 -1 -1 -1 -1 -1 -1 -1 -1
11 11 6 -1 -1 -1 -1 0 0 -1 -1 -1 -1 -1 -1 -1 -1
-1 -1 -1 -1 -1 -1 -1 0 0 -1 -1 5 11 11 11 11 11
-1 -1 -1 -1 -1 -1 -1 0 0 -1 -1 -1 -1 -1 -1 -1 -1
-1 -1 -1 5 11 11 11 0 0 -1 -1 -1 -1 -1 -1 -1 -1
-1 -1 -1 -1 -1 -1 -1 0 0 -1 -1 -1 -1 -1 -1 -1 -1
-1 -1 -1 -1 -1 -1 -1 0 0 -1 -1 -1 -1 -1 1 5 11
-1 -1 -1 -1 -1 -1 -1 0 0 -1 -1 -1 -1 -1 -1 -1 -1
11 11 6 -1 -1 -1 -1 0 0 -1 -1 -1 -1 -1 -1 -1 -1
1 -1 -1 -1 -1 -1 -1 0 0 -1 -1 -1 1 5 11 11 11
1 -1 -1 -1 -1 5 11 0 0 -1 -1 -1 -1 -1 -1 -1 -1
1 -1 -1 -1 -1 -1 -1 0 0 -1 -1 -1 -1 -1 -1 -1 -1
11 11 6 -1 -1 -1 -1 0 0 11 11 11 6 -1 -1 -1 -1
1 -1 -1 -1 -1 -1 -1 0 0 -1 -1 -1 -1 -1 -1 -1 -1
1 -1 -1 -1 -1 -1 -1 0 0 -1 -1 -1 -1 -1 -1 -1 -1
1 -1 -1 -1 5 11 11 0 0 -1 -1 -1 -1 -1 -1 -1 -1
1 -1 -1 -1 -1 -1 -1 0 0 -1 -1 -1 -1 -1 -1 -1 -1
1 -1 -1 -1 -1 -1 1 0 0 1 -1 -1 -1 -1 -1 -1 -1
9 1 -1 -1 9 19 20 0 0 18 1 1 9 -1 1 1 9
0 0 0 0 0 0 0 0 0 0 0 0 0 0 0 0 0
0 0 0 0 0 0 0 0 0 0 0 0 0 0 0 0 0