50 75
1 1 1 1 1 1 1 1 1 1 1 1 1 0 0 0 0 0 -1 -1 -1 -1 -1 -1 -1 -1 -1 -1 -1 1 -1 -1 -1 1 -1 -1 -1 -1 -1 0 0 0 1 -1 -1 -1 -1 -1 -1 -1
1 1 1 1 1 1 1 1 1 1 1 1 1 0 0 0 0 0 -1 -1 -1 -1 -1 -1 -1 -1 -1 -1 -1 1 -1 -1 -1 1 -1 -1 -1 -1 -1 0 1 1 1 -1 -1 -1 -1 -1 -1 -1
1 1 1 1 1 1 1 1 1 1 1 1 1 0 0 0 0 0 -1 -1 -1 -1 -1 0 -1 -1 -1 -1 -1 1 -1 -1 -1 1 -1 -1 -1 -1 -1 0 1 1 1 -1 -1 -1 -1 -1 -1 -1
1 1 1 1 1 1 1 1 1 1 1 1 1 0 0 0 0 0 1 -1 -1 -1 -1 -1 -1 -1 -1 -1 -1 1 -1 -1 -1 1 -1 -1 -1 -1 -1 0 1 1 1 -1 3 -1 -1 -1 -1 -1
1 1 1 1 1 1 1 1 1 1 1 1 1 0 0 0 0 0 -1 -1 -1 -1 -1 -1 -1 -1 -1 -1 -1 1 -1 -1 -1 1 -1 -1 -1 -1 -1 0 0 0 6 -1 -1 -1 -1 -1 -1 -1
1 1 1 1 1 1 1 1 1 1 1 1 1 0 0 0 0 0 -1 -1 -1 -1 -1 -1 -1 -1 -1 -1 -1 1 -1 -1 -1 1 -1 -1 -1 -1 -1 0 0 0 1 -1 -1 -1 -1 10 -1 10
1 1 1 1 1 1 1 1 1 1 1 1 1 0 0 0 0 0 -1 -1 -1 -1 -1 -1 -1 -1 -1 -1 -1 1 -1 -1 1 1 -1 -1 -1 -1 -1 0 0 0 1 -1 1 1 5 0 0 0
1 1 1 3 1 1 1 1 1 3 1 1 1 1 1 1 1 1 -1 -1 -1 -1 -1 -1 -1 -1 -1 -1 -1 1 -1 -1 1 1 -1 -1 -1 -1 -1 0 0 0 1 -1 -1 -1 -1 0 0 0
1 1 1 1 1 1 1 1 1 1 1 1 1 1 1 1 1 1 -1 -1 -1 -1 -1 -1 -1 -1 -1 -1 -1 1 -1 -1 1 1 -1 -1 -1 -1 -1 0 0 0 1 -1 3 -1 -1 0 0 0
1 1 1 1 1 1 1 1 1 1 1 1 1 0 0 0 0 0 -1 -1 -1 -1 -1 -1 -1 -1 -1 -1 -1 1 -1 -1 1 1 -1 -1 -1 -1 -1 0 0 0 1 -1 -1 -1 -1 0 0 0
1 1 1 1 1 1 1 1 1 1 1 1 1 0 0 0 0 0 1 -1 -1 -1 -1 -1 -1 -1 -1 -1 1 1 -1 -1 -1 1 -1 -1 -1 -1 -1 0 0 0 1 -1 -1 -1 -1 0 0 0
6 1 1 1 1 1 3 1 1 1 1 1 1 0 0 0 0 0 -1 -1 -1 -1 -1 -1 -1 -1 -1 -1 1 1 -1 1 -1 1 -1 -1 -1 -1 -1 0 0 0 1 -1 -1 -1 -1 0 0 0
1 1 1 1 1 1 1 1 1 1 1 1 1 0 0 0 0 0 -1 -1 -1 -1 -1 -1 -1 -1 -1 -1 1 1 -1 1 -1 1 -1 -1 -1 -1 -1 0 0 0 1 -1 1 -1 -1 0 0 0
1 1 1 1 1 1 1 1 1 1 1 1 1 0 0 0 0 0 -1 -1 -1 -1 -1 -1 -1 -1 -1 -1 1 1 1 -1 -1 1 -1 -1 -1 -1 -1 0 0 0 1 -1 3 -1 -1 0 0 0
1 -1 1 -1 -1 1 1 1 1 1 -1 -1 -1 0 0 0 0 0 -1 -1 -1 -1 -1 -1 -1 -1 -1 -1 1 1 1 -1 -1 1 -1 -1 -1 -1 -1 0 0 0 1 -1 -1 -1 -1 0 0 0
1 -1 -1 -1 -1 1 1 1 1 1 -1 -1 -1 0 0 0 0 0 -1 -1 -1 -1 -1 -1 -1 -1 -1 -1 -1 1 1 -1 -1 1 -1 -1 -1 -1 -1 0 0 0 1 -1 -1 -1 -1 0 0 0
1 -1 -1 -1 5 0 0 0 1 -1 -1 -1 -1 0 0 0 0 0 -1 -1 -1 -1 -1 -1 -1 -1 -1 -1 -1 1 -1 -1 -1 1 -1 -1 -1 -1 -1 0 0 0 1 -1 -1 -1 -1 0 0 0
1 1 1 -1 1 0 0 0 11 11 11 11 11 0 0 0 0 0 -1 -1 -1 -1 -1 -1 -1 -1 -1 -1 -1 1 -1 -1 -1 1 -1 -1 -1 -1 -1 0 0 0 1 -1 -1 -1 -1 0 0 0
-1 -1 -1 -1 -1 0 0 0 1 -1 -1 -1 -1 0 0 0 0 0 -1 -1 -1 -1 -1 -1 -1 -1 -1 -1 -1 1 -1 -1 -1 1 1 -1 -1 -1 -1 0 0 0 1 -1 -1 -1 -1 0 0 0
-1 -1 -1 -1 -1 0 0 0 1 1 1 1 -1 0 0 0 0 0 -1 -1 -1 -1 -1 -1 -1 -1 -1 -1 -1 1 -1 1 1 1 -1 -1 -1 -1 -1 0 0 0 1 -1 -1 5 11 0 0 0
11 6 -1 -1 -1 0 0 0 1 -1 -1 -1 -1 0 0 0 0 0 -1 -1 -1 -1 -1 -1 -1 -1 -1 -1 -1 1 1 1 -1 1 -1 -1 -1 -1 -1 0 0 0 1 -1 -1 -1 -1 0 0 0
-1 1 1 1 1 0 0 0 1 1 -1 -1 -1 0 0 0 0 0 -1 -1 -1 -1 -1 -1 -1 -1 -1 -1 -1 1 1 -1 -1 1 -1 -1 -1 -1 -1 0 0 0 1 -1 -1 -1 -1 0 0 0
-1 -1 1 1 -1 0 0 0 1 1 -1 -1 1 0 0 0 0 0 -1 -1 -1 -1 -1 -1 -1 -1 -1 -1 -1 1 -1 -1 -1 1 -1 -1 -1 -1 -1 0 0 0 1 -1 -1 -1 -1 0 0 0
-1 -1 -1 -1 1 0 0 0 1 1 -1 -1 -1 0 0 0 0 0 -1 -1 -1 -1 -1 -1 -1 -1 -1 -1 -1 1 -1 -1 -1 1 -1 -1 -1 -1 -1 0 0 0 6 -1 -1 -1 -1 0 0 0
6 -1 -1 -1 1 0 0 0 11 11 11 6 -1 0 0 0 0 0 -1 -1 -1 -1 -1 1 1 1 1 -1 -1 1 -1 -1 -1 1 -1 -1 -1 -1 -1 0 0 0 1 -1 -1 -1 1 0 0 0
-1 -1 -1 -1 -1 0 0 0 1 -1 -1 -1 -1 0 0 0 0 0 -1 -1 -1 -1 5 0 0 0 1 -1 1 1 -1 -1 -1 1 -1 -1 -1 -1 -1 0 0 0 1 -1 -1 -1 1 0 0 0
-1 -1 -1 -1 -1 0 0 0 1 -1 -1 -1 1 0 0 0 0 0 -1 -1 -1 1 1 0 0 0 1 1 1 1 -1 -1 -1 1 -1 -1 -1 -1 -1 0 0 0 1 -1 -1 -1 1 0 0 0
-1 -1 -1 -1 1 0 0 0 1 1 1 1 1 0 0 0 0 0 -1 -1 -1 1 1 0 0 0 1 1 1 1 -1 -1 -1 1 -1 -1 -1 -1 -1 0 0 0 11 6 -1 -1 1 0 0 0
-1 -1 5 11 11 0 0 0 1 -1 -1 -1 1 0 0 0 0 0 6 -1 -1 1 1 0 0 0 1 1 1 1 -1 -1 1 1 -1 -1 -1 -1 -1 0 0 0 -1 -1 -1 -1 1 0 0 0
-1 -1 -1 -1 -1 0 0 0 1 1 -1 -1 1 0 0 0 0 0 -1 -1 -1 1 -1 0 0 0 1 1 -1 1 -1 -1 -1 1 -1 -1 -1 -1 -1 0 0 0 -1 -1 -1 -1 -1 0 0 0
1 1 1 -1 -1 0 0 0 1 1 5 11 11 0 0 0 0 0 -1 -1 -1 -1 -1 0 0 0 -1 -1 -1 1 1 -1 -1 1 -1 -1 -1 -1 -1 0 0 0 -1 -1 -1 -1 -1 0 0 0
-1 1 1 -1 -1 0 0 0 1 1 1 1 1 0 0 0 0 0 -1 -1 -1 -1 -1 0 0 0 -1 -1 -1 1 -1 -1 1 1 -1 -1 -1 -1 -1 0 0 0 11 11 6 -1 -1 0 0 0
-1 -1 1 5 11 0 0 0 1 1 -1 -1 -1 0 0 0 0 0 11 11 6 -1 -1 0 0 0 -1 -1 -1 1 1 -1 1 1 -1 -1 -1 -1 -1 0 0 0 -1 1 1 -1 -1 0 0 0
-1 -1 1 1 1 0 0 0 1 -1 -1 -1 -1 0 0 0 0 0 -1 -1 -1 -1 -1 0 0 0 -1 -1 -1 1 1 -1 1 1 -1 -1 -1 -1 -1 0 0 0 -1 -1 -1 -1 -1 0 0 0
-1 -1 -1 -1 -1 0 0 0 1 -1 -1 -1 -1 0 0 0 0 0 -1 -1 -1 -1 -1 0 0 0 -1 -1 -1 1 1 -1 1 1 -1 -1 -1 -1 -1 0 0 0 -1 -1 -1 -1 -1 0 0 0
-1 -1 -1 -1 -1 0 0 0 1 -1 -1 -1 -1 0 0 0 0 0 -1 -1 -1 -1 -1 0 0 0 -1 -1 -1 1 1 -1 1 1 -1 -1 -1 -1 -1 0 0 0 -1 -1 -1 -1 5 0 0 0
6 -1 -1 -1 -1 0 0 0 11 11 11 11 11 0 0 0 0 0 1 1 1 -1 5 0 0 0 -1 -1 -1 1 -1 -1 -1 1 -1 -1 -1 -1 -1 0 0 0 -1 -1 -1 -1 -1 0 0 0
1 1 1 -1 -1 0 0 0 1 -1 -1 -1 -1 0 0 0 0 0 1 -1 -1 -1 -1 0 0 0 -1 -1 -1 1 -1 -1 1 1 1 -1 -1 -1 -1 0 0 0 -1 -1 -1 -1 -1 0 0 0
1 1 -1 -1 -1 0 0 0 1 -1 -1 -1 1 0 0 0 0 0 -1 -1 -1 -1 -1 0 0 0 -1 -1 -1 1 -1 -1 1 1 1 -1 -1 -1 -1 0 0 0 -1 -1 -1 -1 -1 0 0 0
1 1 -1 -1 -1 0 0 0 1 -1 -1 -1 -1 0 0 0 0 0 -1 -1 -1 -1 -1 0 0 0 -1 -1 -1 1 -1 1 1 1 1 -1 -1 -1 -1 0 0 0 11 11 11 11 11 0 0 0
11 6 -1 -1 -1 0 0 0 1 -1 -1 -1 -1 0 0 0 0 0 -1 -1 -1 5 11 0 0 0 -1 -1 -1 1 -1 1 1 1 1 -1 -1 -1 -1 0 0 0 -1 -1 -1 -1 -1 0 0 0
1 1 1 -1 -1 0 0 0 1 1 1 1 1 0 0 0 0 0 -1 -1 -1 -1 -1 0 0 0 -1 -1 -1 1 -1 -1 1 1 1 -1 -1 -1 -1 0 0 0 -1 -1 -1 -1 -1 0 0 0
1 -1 -1 -1 -1 0 0 0 1 -1 -1 -1 1 0 0 0 0 0 -1 -1 -1 -1 -1 0 0 0 -1 -1 -1 1 1 -1 1 1 1 -1 -1 -1 -1 0 0 0 -1 -1 -1 -1 -1 0 0 0
1 -1 -1 -1 -1 0 0 0 1 -1 1 1 1 0 0 0 0 0 -1 -1 -1 -1 1 0 0 0 -1 -1 -1 1 1 -1 1 1 1 -1 -1 -1 -1 0 0 0 6 -1 -1 -1 1 0 0 0
11 11 6 -1 1 0 0 0 11 6 -1 -1 1 0 0 0 0 0 11 11 11 11 11 0 0 0 -1 -1 -1 1 -1 -1 -1 1 -1 -1 -1 -1 -1 0 0 0 -1 -1 -1 -1 -1 0 0 0
1 -1 -1 -1 -1 0 0 0 1 -1 -1 -1 1 0 0 0 0 0 -1 -1 -1 -1 1 0 0 0 -1 -1 1 1 -1 -1 -1 1 -1 -1 -1 -1 -1 0 0 0 -1 -1 -1 -1 -1 0 0 0
1 -1 -1 -1 5 0 0 0 1 1 -1 -1 1 0 0 0 0 0 -1 -1 -1 -1 1 0 0 0 -1 -1 1 1 -1 -1 -1 1 -1 -1 -1 -1 -1 0 0 0 -1 -1 -1 -1 -1 0 0 0
1 1 1 -1 1 0 0 0 1 1 1 1 1 0 0 0 0 0 -1 -1 -1 -1 1 0 0 0 -1 -1 1 1 -1 -1 -1 1 -1 -1 -1 -1 -1 0 0 0 -1 -1 -1 5 11 0 0 0
6 1 1 1 1 0 0 0 1 1 1 1 1 0 0 0 0 0 11 11 6 -1 1 0 0 0 -1 -1 1 1 -1 -1 -1 1 -1 -1 -1 -1 -1 0 0 0 -1 -1 -1 -1 -1 0 0 0
1 1 1 1 1 0 0 0 1 1 1 1 1 0 0 0 0 0 -1 -1 -1 -1 1 0 0 0 -1 -1 -1 1 -1 -1 -1 1 -1 -1 -1 -1 -1 0 0 0 -1 -1 -1 -1 -1 0 0 0
-1 -1 -1 -1 -1 0 0 0 1 1 1 1 1 0 0 0 0 0 -1 -1 -1 -1 1 0 0 0 -1 -1 1 1 -1 -1 -1 1 -1 -1 -1 -1 -1 0 0 0 -1 -1 -1 -1 -1 0 0 0
-1 -1 -1 -1 -1 0 0 0 -1 -1 -1 -1 -1 0 0 0 0 0 1 -1 -1 -1 1 0 0 0 -1 -1 1 1 -1 -1 -1 1 -1 -1 -1 -1 -1 0 0 0 -1 -1 -1 -1 5 0 0 0
-1 -1 5 11 11 0 0 0 11 11 11 11 11 0 0 0 0 0 6 -1 -1 -1 1 0 0 0 -1 -1 1 1 -1 -1 -1 1 -1 -1 -1 -1 -1 0 0 0 -1 -1 -1 -1 -1 0 0 0
-1 -1 -1 -1 -1 0 0 0 -1 -1 -1 -1 -1 0 0 0 0 0 -1 -1 -1 -1 1 0 0 0 -1 -1 1 1 -1 -1 -1 1 -1 -1 -1 -1 -1 0 0 0 -1 -1 -1 -1 -1 0 0 0
-1 -1 -1 -1 -1 0 0 0 -1 -1 -1 -1 -1 0 0 0 0 0 -1 -1 -1 -1 1 0 0 0 -1 -1 -1 1 -1 -1 -1 1 -1 -1 -1 -1 -1 0 0 0 6 -1 -1 -1 -1 0 0 0
-1 -1 -1 -1 -1 0 0 0 -1 -1 -1 -1 -1 0 0 0 0 0 -1 -1 -1 -1 1 0 0 0 -1 -1 -1 1 -1 -1 -1 1 -1 -1 -1 -1 -1 0 0 0 -1 -1 -1 -1 -1 0 0 0
-1 -1 -1 5 11 0 0 0 -1 -1 -1 -1 -1 0 0 0 0 0 -1 -1 5 11 11 0 0 0 -1 -1 -1 1 -1 -1 -1 1 -1 -1 -1 -1 -1 0 0 0 -1 -1 -1 -1 -1 0 0 0
-1 -1 -1 -1 -1 0 0 0 -1 -1 -1 -1 -1 0 0 0 0 0 -1 -1 -1 -1 -1 0 0 0 -1 -1 -1 1 -1 -1 -1 1 -1 -1 -1 -1 -1 0 0 0 -1 -1 -1 -1 -1 0 0 0
-1 -1 -1 -1 -1 0 0 0 -1 -1 -1 -1 -1 0 0 0 0 0 -1 -1 -1 -1 -1 0 0 0 -1 -1 -1 1 -1 -1 -1 1 1 -1 -1 -1 -1 0 0 0 -1 -1 5 11 11 0 0 0
1 -1 -1 -1 -1 0 0 0 -1 -1 1 1 5 0 0 0 0 0 -1 -1 -1 -1 -1 0 0 0 -1 -1 -1 1 -1 -1 -1 1 1 -1 -1 -1 -1 0 0 0 -1 -1 -1 -1 -1 0 0 0
6 -1 -1 -1 -1 0 0 0 -1 -1 -1 -1 -1 0 0 0 0 0 -1 3 -1 -1 1 0 0 0 -1 -1 -1 1 -1 -1 -1 1 1 -1 -1 -1 -1 0 0 0 -1 -1 -1 -1 -1 0 0 0
-1 -1 -1 -1 -1 0 0 0 -1 -1 -1 -1 -1 0 0 0 0 0 -1 -1 -1 -1 1 0 0 0 -1 -1 -1 1 -1 -1 -1 1 1 -1 -1 -1 -1 0 0 0 -1 -1 -1 -1 -1 0 0 0
-1 -1 -1 -1 -1 0 0 0 -1 -1 -1 -1 -1 0 0 0 0 0 -1 -1 -1 -1 1 0 0 0 -1 -1 -1 1 -1 -1 -1 1 1 -1 -1 -1 -1 0 0 0 -1 -1 -1 -1 5 0 0 0
-1 -1 -1 -1 -1 0 0 0 -1 -1 -1 -1 -1 0 0 0 0 0 -1 -1 -1 -1 1 0 0 0 -1 -1 -1 1 -1 -1 -1 1 1 -1 -1 -1 -1 0 0 0 1 -1 -1 -1 -1 0 0 0
11 6 -1 -1 -1 0 0 0 -1 -1 -1 -1 -1 0 0 0 0 0 -1 -1 -1 -1 -1 0 0 0 -1 -1 -1 1 1 -1 -1 1 -1 -1 -1 -1 0 0 0 0 0 1 -1 1 1 0 0 0
-1 -1 -1 -1 -1 0 0 0 -1 -1 -1 -1 -1 0 0 0 0 0 -1 -1 -1 5 11 0 0 0 -1 -1 -1 1 1 1 1 1 1 -1 -1 0 0 0 0 0 0 0 -1 1 1 0 0 0
-1 -1 -1 -1 -1 0 0 0 11 11 11 11 11 0 0 0 0 0 -1 -1 -1 -1 -1 0 0 0 -1 -1 -1 1 1 1 1 1 1 -1 0 0 0 0 0 0 0 0 0 1 1 0 0 0
-1 -1 -1 -1 -1 0 0 0 -1 -1 -1 -1 -1 0 0 0 0 0 -1 -1 -1 -1 -1 0 0 0 -1 -1 -1 1 -1 1 1 1 1 -1 0 0 0 0 0 0 0 0 0 1 1 0 0 0
-1 -1 5 11 11 0 0 0 -1 -1 -1 -1 -1 0 0 0 0 0 -1 -1 -1 -1 -1 0 0 0 -1 -1 -1 1 -1 1 1 1 1 -1 1 0 0 0 0 0 0 0 1 1 1 0 0 0
-1 -1 -1 -1 -1 0 0 0 -1 -1 -1 -1 -1 0 0 0 0 0 6 -1 -1 -1 -1 0 0 0 -1 -1 -1 1 -1 1 1 1 1 -1 1 1 0 0 0 0 0 11 11 11 11 0 0 0
-1 -1 -1 -1 -1 0 0 0 -1 -1 -1 1 -1 0 0 0 0 0 -1 -1 -1 -1 -1 0 0 0 -1 -1 -1 1 -1 1 1 1 1 -1 -1 1 1 0 0 0 1 1 -1 1 1 0 0 0
-1 -1 -1 -1 -1 0 0 0 -1 -1 -1 1 1 1 1 1 1 1 -1 -1 -1 -1 -1 0 0 0 -1 -1 -1 1 -1 1 1 1 1 -1 -1 -1 1 1 1 1 1 -1 -1 1 1 0 0 0
9 -1 -1 -1 9 0 0 0 -1 -1 -1 -1 -1 1 1 1 1 1 -1 -1 -1 -1 -1 0 0 0 -1 -1 -1 1 -1 1 1 1 1 -1 -1 -1 -1 -1 -1 -1 -1 -1 -1 1 1 0 0 0
0 0 0 0 0 0 0 0 0 0 0 0 0 0 0 0 0 0 0 0 0 0 0 0 0 0 0 0 0 0 0 0 0 0 0 0 0 0 0 0 0 0 0 0 0 0 0 0 0 0
0 0 0 0 0 0 0 0 0 0 0 0 0 0 0 0 0 0 0 0 0 0 0 0 0 0 0 0 0 0 0 0 0 0 0 0 0 0 0 0 0 0 0 0 0 0 0 0 0 0